# 火星文（单字）
# 本文件中仅包含《通用规范汉字表》（2013年）一级字，数据来自网络聚合。
#
# 一级字	火星文	火星文2

一	①	┅
乙	乁	
二	②	
十	拾	┿
丁	玎	
厂	廠	
七	⑦	
八	仈	
人	亾	囚
入	叺	
儿	ル	ㄦ
几	凢	幾
九	勼	
了	孒	叻
刀	叨	
力	劦	仂
乃	釢	
又	叒	
三	彡	
干	迀	幹
于	纡	於
亏	扝	虧
工	笁	
土	汢	
士	仕	壵
才	財	
下	芐	丅
寸	籿	団
大	汏	夶
丈	扙	
与	玙	與
万	萭	萬
上	仩	
小	尒	曉
口	囗	ロ
山	屾	
巾	凧	
千	芉	
乞	阣	
川	巛	〣
亿	億	
个	個	
夕	汐	
久	玖	
么	庅	仫
勺	汋	
凡	汎	
丸	汍	
及	彶	
广	広	廣
亡	匄	
门	閄	闁
丫	吖	
义	義	図
之	と	の
尸	迉	屍
已	巳	
弓	弖	
子	ふ	孓
卫	衞	衛
也	竾	吔
女	囡	
刃	刄	
飞	飛	飝
习	習	
叉	紁	
马	骉	
乡	芗	鄉
丰	仹	豐
王	迋	
开	閞	開
井	丼	囲
天	兲	
夫	玞	
元	沅	え
无	嘸	無
云	囩	雲
专	抟	專
扎	紥	紮
艺	兿	藝
木	朩	
五	伍	
支	伎	
厅	廰	廳
不	芣	鈈
犬	吠	猋
太	忲	呔
区	岖	區
历	呖	曆
友	伖	
匹	苉	
车	車	
巨	姖	
牙	厊	
比	仳	
互	沍	
切	苆	
瓦	咓	
止	圵	
少	仯	尐
日	ㄖ	
中	狆	ф
贝	赑	贔
冈	罓	岡
内	禸	內
水	渁	沝
见	見	
午	吘	
牛	犇	
手	掱	
气	氣	気
毛	毝	
升	圱	
长	萇	長
仁	芢	
片	爿	
仆	圤	
化	囮	
币		幣
仅	僅	
斤	釿	
介	夰	
从	苁	從
仑		侖
今	妗	紟
凶	兇	
分	汾	
乏	疺	
公	厷	
仓	仺	倉
月	仴	
勿	匢	
欠	芡	
风	颩	闏
丹	冄	丼
匀	枃	勻
乌	烏	
勾	芶	
凤	鳯	鳳
六	陸	
文	妏	攵
亢	囥	
方	汸	
火	焱	吙
为	潙	為
斗	乧	鬥
忆		憶
计	計	
订	忊	訂
户	戶	
认	認	
讥		譏
心	杺	惢
尺	呎	
引	吲	
丑	忸	醜
巴	妑	
孔	芤	
队	隊	
办	刅	か
以	姒	鉯
允	狁	尣
邓	郰	鄧
劝	勧	勸
双	叒	雙
书	書	圕
幻	抝	
玉	砡	玊
刊	刋	
未	沬	
末	沬	
示	沶	
击		擊
打	咑	
正	囸	㊣
扑	圤	撲
扒	朳	
功	糼	
去	厾	
甘	苷	咁
世	迣	卋
艾	銰	
古	咕	
节	兯	節
本	夲	
术	朮	術
可	妸	鈳
丙	眪	
左	咗	
厉	疠	厲
石	坧	
右	祐	
布	鈽	咘
龙	瀧	龖
平	岼	
灭	搣	滅
轧		軋
东	崬	東
卡	鉲	
北	苝	丠
占	颭	
卢	盧	
业	鄴	業
旧	舊	
帅	帥	
归	歸	
旦	狚	
目	朩	
且	苴	
叶	旪	
甲	曱	
申	妽	
叮	汀	
电	電	
号	呺	號
田	甶	畾
由	甴	
只	呮	
叭	朳	
央	姎	
兄	兇	
叽	嘰	
叼	汈	
叫	嘂	
另	叧	
叹	嘆	歎
冉	姌	
四	④	
生	泩	苼
失	妷	夨
乍	咋	
禾	秝	
丘	坵	
付	苻	
仗	扙	
代	笩	玳
仙	佡	
们	們	
仪	儀	
白	皛	苩
他	彵	
瓜	呱	
乎	苸	
丛	苁	叢
令	泠	囹
用	鼡	
印	茚	
尔	尒	爾
乐	泺	圞
句	呴	
匆	茐	
册	冊	
卯	茆	
犯	氾	
外	迯	
处	處	
冬	笗	
鸟	茑	
务	務	
包	笣	
饥		饑
主	炷	
市	巿	
立	竝	
冯	溤	馮
玄	玆	
闪	閁	閃
兰	蘭	
半	柈	
汁	汥	
汇	匯	彙
头	頭	
汉	漢	
宁	苧	寧
穴	泬	
它	咜	
讨	討	
写	冩	寫
让	讓	
礼		禮
训	訓	
议		議
必	怭	
讯	卂	訊
记	汜	記
永	怺	詠
司	呞	
尼	胒	
民	姄	囻
弘	宖	
出	炪	絀
辽		遼
奶	艿	
奴	伮	
召	佋	
加	咖	
皮	怶	
边	笾	邊
孕	夃	
发	潑	發
圣	聖	
对	怼	對
台	珆	囼
矛	罞	
纠	糾	
母	毋	
幼	孧	呦
丝	噝	絲
邦	綁	
式	鉽	
迂	扜	
刑	鉶	
动	憅	動
扛	摃	
寺	峙	
吉	咭	
扣	釦	
考	栲	
托	仛	
老	荖	咾
巩		鞏
执	秇	執
扩	拡	擴
扫	掃	
地	哋	
场	畼	場
扬	婸	揚
耳	洱	聑
共	珙	囲
芒	笀	
亚	亞	亜
芝	芷	
朴	圤	樸
机	僟	機
权	權	
过	過	
臣	烥	
再	侢	洅
协	拹	協
西	覀	
压	壓	
厌	厭	
在	茬	
百	咟	
有	洧	
存	洊	
而	洏	
页	頁	
夸	洿	誇
夺	奪	
灰	洃	咴
达	垯	達
列	烮	
死	屍	迉
成	荿	
夹	夾	
轨	匦	軌
邪	峫	
尧		堯
划	劃	
迈	邁	
毕	滭	畢
至	臸	
此	泚	
贞	浈	貞
师	溮	師
尘		塵
劣	挘	
光	洸	咣
当	當	
早	皁	
吁		籲
吐	汢	
吓	圷	嚇
虫	蟲	
曲	浀	
团	團	
吕	焒	呂
同	哃	
吊	铞	
吃	阣	
因	洇	
吸	扱	
吗	嬤	嗎
屿		嶼
岁	嵗	歲
帆	汎	
回	冋	囙
岂	豈	
则	荝	則
刚	碙	剛
网	蛧	網
肉	禸	
年	姩	
朱	咮	
先	姺	
丢	丟	
廷	侹	
舌	舙	
竹	艸	
迁		遷
乔	喬	
伟	偉	
传	伝	傳
休	咻	
伍	⑤	
伏	茯	
优	沋	優
伐	浌	
延	娫	
任	姙	
伤	傷	
价	價	
伦	囵	倫
份	妢	
华	澕	囮
仰	卬	
仿	汸	
伙	钬	夥
伪	沩	偽
自	洎	
伊	吚	
血	洫	
向	姠	
似	姒	
后	後	
行	垳	荇
舟	洀	
全	洤	铨
会	浍	茴
杀	摋	殺
合	匼	
兆	狣	
企	佱	
众	衆	眾
爷	爺	
伞	傘	
创	創	
肋	叻	
朵	朶	
杂	卆	雜
危	佹	
旬	洵	
旭	旮	
负	萯	負
名	洺	
各	茖	
多	哆	
争	踭	爭
色	脃	銫
壮	匨	壯
冲	沖	
妆	妝	
冰	栤	
庄	圧	莊
庆		慶
亦	洂	
刘	嚠	劉
齐	斉	齊
交	茭	
衣	扆	衤
次	佽	
产	浐	產
决	吷	決
充	茺	
闭	閉	
问	問	
闯	闖	
羊	咩	羴
并	並	
关	関	關
米	洣	
灯	燈	
州	詶	
汗	汙	
污	汚	汙
江	茳	
汛	卂	
池	肔	
汝	肗	
汤	饧	湯
忙	杧	
兴	興	
宇	荢	
守	垨	
字	牸	芓
安	鮟	咹
讲	講	
讳		諱
军	軍	
讶	冴	訝
许	汻	許
讹		訛
论	囵	論
讼		訟
农	哝	農
讽		諷
设	蔎	設
访	汸	訪
诀	吷	訣
寻	浔	尋
那	哪	
迅	卂	
尽	浕	盡
导		導
异	異	
弛	肔	
孙	孫	
阵	俥	陣
阳	陽	
收	荍	
阶		階
阴	隂	陰
防	汸	
奸	奷	
如	洳	
妇		婦
好	恏	
她	咜	
妈	媽	
戏	戱	戲
观	觀	
欢	歡	
买	荬	買
红	葒	紅
驮	駞	馱
纤	汘	纖
驯	紃	馴
约	箹	約
级		級
纪	汜	紀
驰	肔	馳
纫		紉
巡	廵	
寿	壽	
弄	挵	
麦	麥	
玛	犸	瑪
进	琎	進
戒	悈	
吞	昋	
远	逺	遠
违	違	
韧		韌
运	運	
扶	荴	
抚		撫
坛	墵	壇
坏	壞	
抠	摳	
扰	擾	
拒	岠	
批	纰	
址	歮	
走	趉	赱
抄	莏	
贡	貢	
坝		壩
攻	糼	
赤	哧	
折	菥	
抡	囵	掄
扮	汾	
抢	熗	搶
孝	涍	
均	汮	
抛	拋	
坟	墳	
坑	妔	
抗	忼	
坊	汸	
抖	鬦	
护	戶	護
壳	涜	殼
志	梽	
块	赽	塊
扭	沑	
声	殸	聲
把	妑	紦
报	蕔	報
拟	抳	擬
却	卻	
抒	杼	
芜	蕪	
苇		葦
芽	厊	
花	埖	婲
芬	棼	
苍	芲	蒼
芳	淓	
严	嚴	
芦	廬	蘆
劳	崂	勞
克	尅	
芭	妑	
苏	蘇	
杠	釭	
杜	荰	
材	財	
村	籿	
杖	粀	
杏	莕	
巫	莁	
极		極
杨	昜	楊
求	浗	
更	浭	哽
束	娕	
吾	圄	
豆	荳	
两	倆	両
丽	婯	麗
医	悘	醫
辰	宸	
励		勵
否	娝	
还	還	
歼	姧	殲
来	唻	
连	涟	連
轩	蓒	軒
步	荹	
卤		鹵
坚	堅	
旱	猂	
盯	饤	
呈	珵	
时	溡	塒
吴	呉	吳
助	莇	
县	縣	
里		裏
呆	槑	
吱	汥	
呕	嘔	
园	圎	園
旷	纩	曠
围	圍	
呀	吖	
吨	沌	噸
足	娖	
邮		郵
男	莮	侽
困	涃	
吵	訬	
串	賗	
员	園	員
呐	妠	
听	厛	聽
吟	荶	
吩	玢	
呛	濸	嗆
吻	沕	
吹	欥	
呜	嗚	
吭	妔	
吧	妑	
吼	犼	
别	莂	別
岖	嶇	
岗	罓	崗
帐	賬	帳
财	財	
针	針	
钉	町	釘
告	哠	
我	莪	
乱	亂	
利	悡	
秃	禿	
秀	莠	
私	俬	
每	烸	
兵	娦	
估	诂	
体	軆	體
何	哬	
佑	祐	
但	泹	
伸	訷	
作	莋	
佣	砽	傭
低	彽	
你	沵	伱
住	炷	
位	莅	
伴	柈	
身	裑	
皂	唣	
佛	仏	
囱		囪
近	菦	
彻	沏	徹
余	悇	餘
希	唏	
坐	唑	
谷	唂	穀
妥	鋖	
含	浛	
邻	鄰	
肛	釭	
肠		腸
龟	亀	龜
免	凂	
狂	誑	
犹	沋	猶
狈		狽
删	剼	刪
条	條	
彤	浵	
岛	島	
刨	铇	
迎	迊	
饭	粄	飯
饮	飮	飲
系	係	
言	訁	
冻	岽	凍
状	匨	狀
亩	畝	
况	況	
库	厙	庫
疗	療	
吝	悋	
应	應	
这	適	這
冷	唥	
庐	廬	
序	垿	
辛	厗	
弃	棄	
忘	莣	
闰	潤	閏
闲	娴	閑
间	簡	間
闷	悶	
判	叛	
兑	兌	
灿		燦
弟	弚	
汪	忹	
汰	呔	
沥		瀝
沙	乷	
沦	囵	淪
汹		洶
泛	疺	
沧	獊	滄
没	莈	
沟	芶	溝
沪	戶	滬
沈	瀋	
沉	冗	
怀	懷	
忧	沋	憂
快	赽	
完	唍	
宋	浨	
宏	宖	
牢	窂	
穷	窮	
灾	災	
良	悢	
证	姃	證
启	晵	啟
评		評
补	卟	補
社	涻	
识	識	
诈	怍	詐
诉	訴	
罕	癷	
诊	沴	診
词	詞	
译	譯	
君	焄	
灵	靈	
即	旣	
层	層	
屁	庇	
尿	杘	
尾	屗	
迟	呎	遲
局	挶	
改	妀	
张	張	涨
际	漈	際
陆	陸	
阿	婀	
陈	陳	
阻	蒩	
附	胕	
坠	墜	
妙	仯	
妖	岆	
努	怓	
忍	涊	
劲	勁	
鸡	鶏	雞
纬		緯
驱	駆	驅
纯	蒓	純
纱		紗
纲	罁	綱
纳	妠	納
驳	訤	駁
纵	枞	縱
纷	妢	紛
纸	衹	紙
纹	鈫	紋
纺	汸	紡
驴	馿	驢
纽	狃	紐
奉	唪	
玩	琓	
环	寰	環
武	娬	
青	圊	
责	嫧	責
现	哯	
玫	坆	
表	錶	
规	規	
抹	沬	
拓	沰	
拢	泷	攏
拔	菝	
坪	岼	
拣		揀
坦	钽	
担	泹	擔
坤	堒	
押	呷	
抽	菗	
拐	枴	
拖	柂	
者	鍺	
拍	啪	
顶	嵿	頂
拎	柃	
拥	砽	擁
拘	佝	
势	勢	
抱	砲	菢
垃	柆	
拉	菈	
拦		攔
幸	圉	
拌	絆	
拧		擰
拙	炪	
招	妱	
坡	岥	
披	怶	
拨	妭	撥
择	萚	擇
抬	孡	
其	娸	
取	掫	
苦	楛	
昔	厝	
苛	岢	
若	婼	
苹	泙	蘋
苗	媌	
英	渶	
苑	夗	
范	笵	
直	矗	
茄	苆	
茎	莖	
茅	罞	
枉	忹	
林	啉	
枝	汥	
杯	柸	
枢		樞
柜	匱	櫃
析	唽	
板	闆	
松	菘	
枪	熗	槍
枫	猦	楓
构	媾	構
杭	忼	
杰	傑	
述	沭	
枕	忱	
丧	喪	
或	戓	
画	畵	畫
卧	臥	
事	倳	
刺	剌	
枣	栆	棗
卖	賣	
郁	喐	鬱
矾		礬
矿	纩	礦
码	犸	碼
厕	厠	廁
奈	柰	
奔	渀	
奇	渏	
奋	奮	
态	忲	態
欧	瓯	歐
殴	瓯	毆
垄	泷	壟
妻	悽	
轰	轟	
顷	頃	
转	啭	轉
斩	斬	
轮	囵	輪
软	軟	
到	菿	箌
非	悱	
叔	埱	菽
歧	忮	
肯	肻	
齿	歯	齒
卓	婥	
虎	唬	虤
虏		虜
肾	腎	
贤	賢	
尚	尙	
旺	忹	
具	倶	
味	菋	
果	淉	
昆	崐	
国	國	
哎	餀	
昌	誯	
呵	哬	
畅		暢
明	眀	朙
易	昜	噫
咙	茏	嚨
昂	昻	
迪	廸	
典	敟	
固	凅	
忠	筗	
呼	苸	
鸣	嘄	鳴
咏	怺	詠
呢	迡	
岩	啱	
帖	萜	
罗	囉	羅
帜		幟
帕	啪	
岭	玪	嶺
凯	剀	凱
败	敗	
账		賬
贩		販
贬	貶	
购	媾	購
贮		貯
图	圖	
钓	銱	釣
制	淛	
知	倁	
垂	箠	
物	粅	
刮	剮	
秆		稈
和	啝	囷
季	悸	
委	逶	
岳	捳	嶽
供	栱	
例	唎	
侠	浹	俠
侥		僥
版	蝂	
侦	浈	偵
侣	佀	侶
侧	側	
凭	憑	
侨	喬	僑
佩	姵	
货	貨	
依	畩	
卑	萆	
的	哋	啲
迫	廹	
质	質	
欣	俽	
征	姃	
往	暀	
爬	瓟	
径	徑	
所	葰	
舍	舎	
金	唫	
刹	閷	
命	掵	
斧	釡	
爸	妑	
觅		覓
受	辤	
贪	貪	
念	淰	
贫	貧	
肤	膚	
肺	腓	
肢	汥	
肿	妕	腫
胀		脹
朋	萠	
股	骰	
肥	萉	
服	棴	垺
胁	脅	
周	淍	
昏	涽	
鱼	渔	鱻
兔	兎	
忽	唿	
狗	豞	
狞		獰
备	備	
饰	飾	
饱	怉	飽
饲		飼
变	變	
京	倞	
享	啍	
庞	厐	龐
店	扂	
夜	液	
庙	庿	廟
府	椨	
底	疧	
疟		瘧
疚	咎	
剂		劑
庚	菮	
废	廢	
净	凈	淨
盲	吂	
放	倣	
刻	尅	
育	唷	
闸	閘	
闹	閙	鬧
郑	鄭	
卷	捲	
单	啴	單
炬	岠	
炕	忼	
炎	烾	燚
炉	爐	
沫	沬	
浅	淺	
法	琺	
泄	绁	
沽	钴	
河	菏	
沾	跕	
泪	汨	淚
油	怞	
泡	垉	
注	炷	紸
泣	淇	
泞		濘
泻	瀉	
泳	怺	
泥	狔	苨
波	菠	
泼	秡	潑
泽	澤	
治	菭	
怔	姃	
怯	愜	
性	悻	
怕	啪	
怜	憐	
学	敩	學
宝	寶	
宗	崈	
定	萣	
宠	寵	
审	谉	審
官	菅	
空	涳	
帘		簾
实	實	
试	鉽	試
郎	蓢	
诗	詩	
诚	諴	誠
衬		襯
衫	釤	
视	視	
话	話	
诞		誕
诡	詭	
询	咰	詢
该	姟	該
详	詳	
建	踺	
肃	歗	肅
录	淥	錄
隶		隸
屉	屟	屜
居	劇	
届	屆	
刷	唰	
弥		彌
弦	妶	
孟	掹	
陌	帞	
孤	箛	
陕	陝	
降	夅	
函	凾	
妹	妺	
姑	菇	
姓	狌	
驾	駕	
叁		三
参	傪	參
艰		艱
线	線	
练	煉	練
组	蒩	組
绅	訷	紳
细	細	
驶	馶	駛
织	枳	織
驹		駒
终	蔠	終
驻		駐
绊		絆
驼	袉	駝
绍	袑	紹
绎		繹
经	經	
贯	遦	貫
贰		貳
奏	楱	
春	舂	
帮	幇	幫
珍	沴	
玲	玪	
珊	姍	
玻	箥	
毒	毐	蝳
型	侀	
挂	啩	掛
封	崶	葑
持	歭	
拷	洘	
拱	珙	
项	頙	項
城	峸	
挟	挾	
挠	撓	
政	炡	
赵	趙	
挡	澢	擋
拽	跩	
哉	酨	
挺	侹	
括	葀	
拾	湁	
挑	狣	
指	栺	
垫		墊
挣	諍	掙
挤	哜	擠
拼	拚	
按	洝	
挥	媈	揮
某	湈	
甚	卙	
荆	荊	
革	愅	
荐	薦	
带	帶	
草	愺	
茧		繭
茵	筃	
茶	嗏	
荒	巟	
茫	汒	
荡	蕩	
荣		榮
荤		葷
荧		熒
故	诂	
胡	箶	
荫		蔭
南	遖	喃
药	葯	藥
标	摽	標
栈	棧	
枯	喖	
柄	窉	
栋	崬	棟
相	楿	
查	楂	
栅		柵
柳	栁	
柱	炷	
柿	枾	
栏	孄	欄
柠		檸
树	樹	
勃		葧
要	婹	偠
咸		鹹
威	媙	
研	妍	
砖	磚	
砂	唦	
砚		硯
砍	歃	
面	媔	
耐	恧	
牵	撁	牽
鸥	瓯	鷗
残	殘	
轴		軸
轻	輕	
鸦	鴉	
皆	湝	
背	揹	褙
战	戰	
点	點	
虐	疟	
临	臨	
览	灠	覽
竖	竪	豎
省	渻	
削	萷	
尝	甞	嘗
是	湜	昰
盼	昐	
眨	喳	
哄	晎	
哑	啞	
显		顯
冒	萺	
映	眏	
星	暒	煋
昨	葃	
畏	嵔	
趴	汃	
胃	媦	
贵	貴	圚
界	鎅	堺
虹	渱	
虾		蝦
蚁		蟻
思	偲	
蚂	犸	螞
虽		雖
品	闆	
骂	罵	
勋	勛	勳
哗	蕐	嘩
咱	洎	
响	姠	響
哈	铪	囧
咬	吆	
咳	嗑	
哟	喲	
炭	湠	
峡	浹	峽
罚	藅	罰
贱	濺	賤
贴	萜	貼
贻	貽	
骨	嗗	
幽	豳	
钙	鈣	
钝	沌	鈍
钞	鈔	
钟	妕	鍾
钢	鋼	
钠	妠	鈉
钥		鑰
钦		欽
钧	呁	鈞
钩	溝	鉤
钮	妞	鈕
卸	啣	
缸	矼	
拜	湃	
矩	怇	
毡		氈
氢		氫
牲	狌	
选	選	
适		適
秒	仯	
香	萫	馫
种	種	
秋	偢	
科	萪	
重	偅	
复	復	複
竿	芉	
段	葮	
便	楩	
俩	唡	倆
贷		貸
顺	順	
修	俢	
俏	佾	
保	湺	
促	娖	
俄	皒	
俭	倹	儉
皇	瑝	
泉	葲	灥
鬼	媿	
侵	埐	
侯	糇	
追	搥	縋
俊	浚	
徊	佪	
律	侓	
很	佷	
须	湏	須
叙	溆	敘
剑	劍	
逃	洮	
食	喰	
盆	湓	
胧	朧	
胆	狚	膽
胜	夝	勝
胞	菢	
胖	眫	
脉	霡	脈
狭	浹	狹
狮	浉	獅
独	獨	
狰		猙
狡	烄	
狱	獄	
狠	哏	
贸	貿	
怨	葾	
急	喼	ゑ
饵	聶	餌
饶	隢	饒
蚀		蝕
饺		餃
饼		餅
峦	欒	巒
弯	塆	彎
将	將	
奖	奨	獎
亭	渟	
亮	煷	
度	喥	
迹		跡
庭	侹	
疮		瘡
疯	瘋	
咨	恣	
姿	恣	
亲	儭	
音	堷	喑
帝	渧	
施	湤	
闺	閨	
闻	聞	
闽	閩	
阀		閥
阁		閣
差	槎	
养	養	
美	羙	媄
姜	葁	薑
叛	判	
送	鎹	
类	類	
迷	洣	
娄	溇	婁
前	湔	
首	渞	
逆	屰	
兹		茲
总	縂	總
炼	煉	
炸	怍	
烁	爍	
炮	垉	
烂	灡	爛
剃	珶	
洼	哇	窪
洁		潔
洪	葓	
洒	灑	
浇		澆
浊		濁
洞	狪	
测	恻	測
洗	冼	
活	萿	
派	哌	
染	媣	
洛	詻	
浏	瀏	
济	哜	濟
洋	樣	
洲	詶	
浑	渾	
浓	哝	濃
津	珒	
恒	恆	
恼	悩	惱
恨	悢	
举	舉	
觉	覺	
宣	媗	
室	厔	
宫	営	宮
宪		憲
突	湥	
穿	瑏	
窃	苆	竊
客	愙	
诫		誡
冠	蒄	
诬	莁	誣
语	娪	語
扁	碥	
袄	仸	襖
祖	袓	
神	鉮	
祝	柷	
误	誤	
诱		誘
诲		誨
说	説	詤
诵	誦	
垦	恳	墾
退	蹆	
既	旣	
屋	偓	
昼		晝
屏	屛	
屎	屍	
费	曊	費
陡	跿	
逊	遜	
眉	葿	
孩	陔	駭
陨	殒	隕
除	篨	
险	険	險
院	阮	
娃	哇	
姥	粩	
姨	侇	
姻	絪	
娇	嬌	
姚	烑	
娜	哪	
怒	伮	
架	泇	
贺	哿	賀
盈	盁	
勇	湧	
柔	渘	
垒		壘
绑	垹	綁
绒	絨	
结	結	
绕	隢	繞
骄	嬌	驕
绘	浍	繪
给		給
绚	絢	
骆	詻	駱
络	絡	
绝	蕝	絕
绞	烄	絞
骇		駭
统	統	
耕	畊	
耘	秐	
耗	秏	
艳	滟	豔
泰	溙	
秦	蓁	
珠	咮	
班	癍	
素	嫊	
匿	嫟	
蚕	蛬	蠶
顽		頑
盏		盞
匪	厞	
捞	崂	撈
栽	酨	
捕	峬	
捂	圄	
振	桭	
载	酨	載
赶	迀	趕
盐	鹽	
捎	哨	
捏	涅	
捉	浞	
捆	涃	
捐	涓	
损	損	
袁	媴	
都	嘟	
哲	悊	
逝	迣	
捡	撿	
换	換	
挽	梚	
挚		摯
热	慹	熱
捣	搗	
壶	壺	
捅	硧	
耻	恥	
聂	嗫	聶
恭	塨	
莽	漭	
莱		萊
莲	嗹	蓮
莫	嗼	
荷	嗬	
获	镬	獲
晋	晉	
恶	悪	惡
莹	瑩	
莺	鶯	
真	嫃	眞
桂	蓕	
栖		棲
档	澢	檔
桐	秱	
桥	喬	橋
桦	樺	
栓	拴	
桃	洮	
格	咯	
桩		樁
核	劾	
样	樣	
根	艮	
索	鎍	
哥	滒	
速	趚	
逗	浢	
贾		賈
配	蓜	
翅	趐	
辱	媷	
唇	脣	
夏	嗄	
砸	咂	
砰	泙	
砾		礫
础	绌	礎
破	岥	
原	厡	
逐	豩	
烈	烮	
殊	姝	
殉	咰	
顾	顧	
轿		轎
较	珓	較
顿	頓	
毙	斃	
致	臸	
柴	枈	
桌	棹	
虑	慮	
监	盬	監
紧	緊	
党	黨	
逞	浧	
晒	曬	
晓	哓	曉
哮	涍	
唠	嘮	
鸭	鴨	
晃	愰	
哺	誧	
晕	暈	
畔	溿	
蚊	螡	
哦	呃	
恩	慁	
鸯	鴦	
唤	喚	
哼	涥	
啊	娿	
唉	呃	
唆	逡	
罢		罷
峨	睋	
峰	峯	
圆	園	圓
峻	浚	
贼	賊	
贿		賄
赂		賂
赃	賍	贓
钱	錢	
钳		鉗
钻	鑽	
钾		鉀
铁	鉄	鐵
铃	玪	鈴
铅	鉛	
缺	蒛	
牺	犠	犧
造	慥	
乘	塖	
敌	敵	
租	蒩	
积	積	
称	稱	
笔	毣	筆
笋		筍
债	債	
借	徣	
值	惪	徝
倚	掎	
俺	唵	
倾	傾	
倒	箌	
俱	倶	
候	糇	
赁	賃	
俯	椨	
倍	俻	
倦	惓	
健	揵	
臭	溴	
躬	匑	
倔	崛	
徒	徙	
徐	俆	
舰		艦
舱		艙
般	瘢	
途	蒤	
拿	嗱	
耸	聳	
爹	嗲	
爱	嬡	愛
颁	頒	
颂	頌	
翁	暡	
胸	洶	
脏	賍	贓
脐		臍
胶	烄	膠
脑	悩	腦
脓	哝	膿
逛	迋	
狼	哴	
逢	漨	
鸵	袉	鴕
留	畱	
鸳	鴛	
皱	皺	
饿	皒	餓
馁	浽	餒
凌	夌	淩
凄		淒
恋	戀	
桨		槳
浆	槳	漿
衰	缞	
高	滈	
郭	漷	
准	痽	
座	蓙	
病	疒	
斋		齋
疼	庝	
离	蓠	離
唐	瑭	
资	粢	資
凉	涼	
站	跕	
竞	競	
部	蔀	
旁	臱	
旅	膂	
阅	閱	
羞	饈	
羔	餻	
瓶	甁	
粉	帉	
益	谥	
兼	凲	
烤	栲	
烦	煩	
烧	燒	
烛		燭
烟	煙	
烙	絡	
递		遞
涛	濤	
浙	淅	
涝	崂	澇
酒	氿	
涉	渉	
涡	煱	渦
浩	滘	
海	嗨	
涂	凃	塗
浮	捊	
涣		渙
涤		滌
流	蓅	鋶
润	潤	
涧		澗
涕	珶	
浪	烺	
浸	锓	
涨		漲
烫		燙
涩	澀	
涌	悀	湧
悟	圄	
悄	佾	
悔	珻	
悯		憫
悦	哾	悅
害	嗐	
宽	寬	
家	傢	镓
宴	匽	
宾	濱	賓
窍	竅	
窄	搾	
容	嫆	
请	埥	請
朗	蓢	
诸	渚	諸
诺	喏	諾
读	渎	讀
扇	傓	
诽		誹
袜	襪	
袍	垉	
课	錁	課
谁	誰	
调	蜩	調
冤	寃	
谅	涼	諒
谆		諄
谈	談	
谊		誼
剥	剝	
恳	垦	懇
展	蹍	
剧	涺	劇
弱	弜	
陵	夌	
陶	匋	
陷	陥	
陪	婄	
娱	娯	娛
娟	涓	
娥	皒	
通	嗵	
难	難	
预	預	
桑	鎟	
绢	涓	絹
绣		繡
验	験	驗
继		繼
骏	浚	駿
球	浗	
琐	鎖	瑣
理		悝
琅	哴	
捧	唪	
堵	陼	
描	媌	
掩	殗	
捷	啑	
排	棑	
焉	漹	
掉	鋽	
捶	腄	
堆	碓	
推	蓷	
掀	锨	
授	涭	
捻		撚
教	嘋	
掏	匋	
掐	拤	
掠	稤	
培	掊	
接	帹	
掷		擲
控	啌	
据	琚	據
掘	崛	
掺	傪	摻
职	轵	職
基	樭	
聊	窷	
娶	婜	
菱	夌	
勒	嘞	
黄	曂	黃
菲	婔	
萌	萠	
萝	囉	蘿
菌	箘	
萎	崣	
菜	婇	
萄	匋	
菊	匊	
菩	箁	
萍	泙	
萤		螢
营	營	
乾	墘	
萧	簘	蕭
萨	蕯	薩
械	悈	
梦	夢	
婪	漤	
梢	哨	
梅	烸	
检	撿	檢
梯	珶	
桶	硧	
梭	逡	
救	慦	
曹	蓸	
副	諨	
票	嘌	
酝		醞
厢		廂
戚	嘁	
硅		矽
硕	碩	
爽	摤	
聋	聾	
袭		襲
盛	墭	
雪	膤	
辅		輔
辆	唡	輛
颅		顱
虚	歔	虛
彪	滮	
堂	漟	
常	瑺	
眶	洭	
晨	曟	
睁	諍	睜
眯	侎	
悬		懸
野	嘢	
啦	菈	
曼	嫚	
晦	珻	
晚	脕	
距	岠	
啃	肻	
跃	跞	躍
略	畧	
蛇	虵	
累	蔂	
唱	晿	
患	漶	
啰		囉
唯	惟	
啥	倽	
啸		嘯
崭		嶄
逻	羅	邏
崔	慛	
崩	镚	
崇	漴	
婴	璎	嬰
圈	圜	
铐	銬	
铛	鐺	
铝	焒	鋁
铜	恫	銅
铭	佲	銘
铲		鏟
银	檭	銀
矫		矯
甜	甛	憇
梨	悡	
秽		穢
移	簃	
笨	苯	
笼	茏	籠
笛	廸	
符	苻	
第	苐	
敏	勄	
做	莋	
悠	滺	
偿		償
偶	耦	
偷	偸	
停	渟	
偏	媥	
躯	軀	
兜	兠	
假	徦	
衅		釁
徘	棑	
得	嘚	
衔	銜	
盘	盤	
盒	盉	
鸽		鴿
敛	潋	斂
欲	慾	
彩	埰	
领	領	
脚	腳	
脸	臉	
脱	脫	
象	潒	
够	夠	
猪	蕏	豬
猎	獵	
猫	貓	
凰	瑝	
猛	掹	
馅	陥	餡
馆	菅	館
凑		湊
减	諴	減
麻	嫲	
痒	癢	
廊	蓢	
康	嫝	
庸	滽	
鹿	蔍	麤
盗	盜	
章	嶂	
竟	獍	
商	啇	
族	蔟	
旋	嫙	
望	朢	
率	卛	
阎	閻	
阐	闡	
着		著
羚	玪	
盖	葢	蓋
粘	秥	
断	斷	
剪	彅	
兽	獣	獸
焊	猂	
焕		煥
清	凊	
添	婖	
鸿	鴻	
淋	啉	
淹	殗	
渐		漸
淑	蔋	
混	婫	
淮	准	
渊	棩	淵
淫	婬	
渔		漁
淘	匋	
淳	錞	
淤	菸	
淡	惔	
淀		澱
深	堔	
涵	凾	
婆	嘙	
梁	樑	
渗	椮	滲
情	凊	
惜	厝	
惭	慙	慚
惧		懼
惊	驚	
惨	參	慘
惯	遦	慣
寇	簆	
寅	夤	
宿	蹜	
窑	窰	窯
密	滵	
谋	湈	謀
谍	媟	諜
谎	巟	謊
谐	喈	諧
祷		禱
祸	禍	
谓	媦	謂
谚		諺
谜	洣	謎
逮	曃	
敢	噉	
尉	墛	
屠	廜	
弹		彈
隋	陏	
堕	憜	墮
随	隨	
蛋	疍	蜑
隆	湰	
隐	陻	隱
婚	殙	
婶	嬸	
婉	啘	
颇	櫇	頗
颈	頸	
绩		績
绪	緒	
续	續	
骑	騏	騎
绰	焯	綽
绳	繩	
维	惟	維
绵	婂	綿
绷		繃
绸	皗	綢
综	琮	綜
绽	綻	
绿	淥	綠
缀	綴	
巢	漅	
琴	噖	
琳	啉	
琼		瓊
斑	癍	
替	櫕	
揍	楱	
款	窾	
塔	嗒	
搭	溚	
越	樾	
趋		趨
超	趫	
揽	灠	攬
堤	諟	
提	諟	
喜	禧	囍
彭	憉	
揣	遄	
插	揷	
揪	啾	
搜	溲	
煮	煑	
援	瑗	
搀		攙
搁	擱	
搓	髊	
搂	嵝	摟
搅		攪
握	楃	
揉	渘	
斯	凘	
期	剘	
欺	剘	
联	聅	聯
葫	煳	
散	潵	
葬	髒	
葛	噶	
董	蓳	
葡	匍	
敬	擏	
葱	茐	蔥
蒋	蔣	
蒂	渧	
韩	韓	
朝	謿	
棒	蜯	
棋	諆	
椰	倻	
植	淔	
森	潹	
椅	掎	
棵	錁	
棍	輥	
棉	婂	
棚	堋	
棕	琮	
棺	菅	
榔	蓈	
椭		橢
逼	腷	
厨	廚	
厦		廈
硬	哽	
确	確	
裂	煭	
颊		頰
雳	靂	
暂	暫	
雅	蕥	
翘	趬	翹
辈	輩	
悲	蕜	
紫	橴	
凿		鑿
辉	媈	輝
棠	橖	
赏	賞	
掌	礃	
晴	啨	
睐	睞	
暑	濐	
最	朂	
量	糧	
喷	濆	噴
晶	瞐	
遇	喁	
喊	諴	
晾	涼	
景	憬	
畴	帱	疇
践		踐
跋	柭	
跌	瓞	
跑	垉	
遗		遺
蛛	咮	
喝	曷	
鹃	鵑	
喂	嵔	
喘	遄	
喉	糇	
啼	渧	
喧	媗	
幅	諨	
帽	萺	
赋	賦	
赌	帾	賭
赎		贖
赐	賜	
赔	婄	賠
黑	嫼	
铸		鑄
铺	舗	鋪
链	嗹	鏈
销		銷
锁	鎻	鎖
锄	鋤	
锅	煱	鍋
锈	琇	鏽
锋	峯	鋒
锌		鋅
锐	銳	
智	潪	
鹅		鵝
剩	乗	
稍	哨	
程	珵	
稀	浠	
税	挩	稅
筐	筺	
筑	茿	築
策	憡	
筛	篩	
筒	茼	
答	荅	
筋	荕	
筝	箏	
傲	謸	
牌	簰	
集	潗	
焦	潐	
傍	徬	
储		儲
粤	粵	
奥	奧	
惩	懲	
御		禦
循	揗	
舒	忬	
逾	揄	
番	畨	
释		釋
禽	噙	
腊	臘	
脾	裨	
鲁	噜	魯
猩	睲	
猬		蝟
猾	磆	
猴	糇	
惫		憊
然	嘫	
馈	潰	饋
馋	镵	饞
装	裝	
蛮	蠻	
就	僦	
痘	哣	
痪		瘓
痛	痌	
童	僮	
竣	浚	
阔	闊	
善	僐	
羡	羨	
粪		糞
尊	澊	
道	檤	噵
遂	嬘	
曾	嶒	
焰	熖	
滞		滯
湖	煳	鍸
渣	碴	
渺	緲	
湿	濕	
温	溫	
渴	渇	
溃	潰	
溅		濺
滑	磆	
渝	揄	
湾	塆	灣
渡	喥	
游	遊	
滋	稵	
溉	漑	
愤	濆	憤
慌	巟	
惰	媠	
愣	楞	
惶	瑝	
愧	隗	
愉	揄	
割	剨	
富	冨	
窜		竄
窝	窉	窩
窗	囱	
窘	僒	
遍	猵	
裤	褲	
裙	峮	
禅	禪	
禄		祿
谢	塮	謝
谣	愮	謠
谤		謗
谦	嗛	謙
属	屬	
屡	屢	
强	強	
嫂	溲	
婿	胥	
登	憕	
缅		緬
缆	灠	纜
缉		緝
缎	葮	緞
缓	緩	
缔		締
缕		縷
骗	騙	
编	揙	編
骚	騒	騷
缘	緣	
鹉	鵡	
摄	摂	攝
摸	嗼	
填	瑱	
塌	禢	
鼓	鼔	
摆	擺	
携		攜
摇	愮	搖
搞	鎬	
塘	溏	
摊		攤
聘	娉	
蒜	祘	
勤	懄	
鹊		鵲
蓝	藍	
墓	募	
幕	募	
蓬	莑	
蓉	嫆	
蒙	懞	
蒸	篜	
献	獻	
禁	噤	
楚	椘	
楷	揩	
榄	欖	
楼	溇	嘍
概	漑	
赖	攋	賴
酪	絡	
酬	絒	
感	憾	
碍		礙
碎	誶	
碰	湴	
碗	涴	
尴	尷	
雷	檑	
零	蕶	
雾	霚	霧
辐		輻
辑		輯
输	瀭	輸
频	頻	
龄	齡	
鉴		鑒
睛	聙	
瞄	媌	
睡	腄	
睬	棌	
鄙	啚	
暖	煖	
盟	擝	
暇	叚	
照	燳	
跷	蹺	
跳	朓	
跪	蛫	
路	蕗	
跟	茛	哏
蜗	窩	蝸
蛾	睋	
蜕		蛻
嗅	溴	
嗡	滃	
嗓	鎟	
罪	嶵	
幌	縨	
错	措	諎
锚		錨
锡	唶	錫
锣	囉	鑼
锤	腄	錘
锥		錐
锦	婂	錦
键	楗	鍵
锯	涺	鋸
锰		錳
矮	婑	
辞	辭	
稚	雉	
稠	婤	
颓		穨
愁	僽	
筹	薵	籌
签	簽	
简	彅	簡
毁	毇	毀
鼠	癙	
催	慛	
傻		儍
像	潒	
躲	躱	
微	嶶	
愈	匬	
遥	滛	遙
腻	膩	
腰	崾	
腥	睲	
鹏	鵬	
腾	駦	騰
腿	蹆	
鲍		鮑
颖	颕	穎
触		觸
煞	繺	
雏	雛	
馍	饃	
馏		餾
酱	醬	
禀	稟	
廓	霩	
痴		癡
新	噺	
韵	韻	
意	嬑	
誊		謄
粮	悢	糧
数	薮	數
塑	愬	
慈	濨	
煤	湈	
煌	瑝	
满	慲	滿
漠	嗼	
源	羱	
滤	慮	濾
滥	嚂	濫
滔	瑫	
溪	渓	
溜	媹	
滚	蔉	滾
滨	璸	濱
溶	嫆	
滩		灘
誉	謍	譽
塞	噻	
窥	窺	
窟	崫	
寝	寑	寢
谨	殣	謹
褂	啩	
福	湢	鍢
谬	繆	謬
群	羣	
辟	澼	
嫌	溓	
嫁	糘	
叠	疉	疊
缚		縛
缝	漨	縫
缠	瀍	纏
缤	繽	
静	靜	
赘		贅
墙	嫱	牆
墟	歔	
摧	凗	
境	璄	
摘	擿	
撇	潎	
聚	藂	
蔓	嫚	
蔑	篾	
蔽	幣	
蔼		藹
熙	凞	
蔚	墛	
模	嗼	
槛		檻
榴	媹	
榜	徬	
榨	搾	
歌	戨	
遭	蹧	
酿		釀
碟	渫	
碱		堿
碳	湠	
磁	濨	
愿	蒝	願
需	濡	
辖	轄	
辗		輾
颗	錁	顆
踊		踴
蜡	臘	蠟
蝇		蠅
蜘	倁	
蝉		蟬
嘛	嫲	
赚	賺	
锹		鍬
锻	葮	鍛
镀		鍍
舞	橆	
舔	婖	
稳	穏	穩
算	匴	
箩	儸	籮
管	涫	
箫	簫	
舆		輿
僚	獠	
鼻	嬶	
貌	邈	
膜	嗼	
膀	嫎	
鲜	鮮	
疑	寲	
馒	獌	饅
敲	毃	
豪	濠	
遮	嗻	
瘦	痩	
端	鍴	
精	棈	
粹	濢	
歉	嗛	
熔	嫆	
潇	瀟	
漂	慓	
漫	嫚	
滴	嘀	
漾	羕	
演	湮	
漏	屚	
慢	嫚	
慷	嵻	
赛	噻	賽
察	镲	
蜜	滵	
谭		譚
褪	蹆	
谱	鐠	譜
嫩	嫰	
翠	濢	
熊	熋	
骡		騾
缩	縮	
撵		攆
撕	凘	
撒	潵	
撩	嫽	
撑	撐	
撬	毳	
播	譒	
擒	檎	
撞	獞	
撤	徹	
增	熷	
聪		聰
鞋	嚡	
蕊	惢	
蕴	藴	蘊
横	橫	
樱	璎	櫻
橡	潒	
飘	彯	飄
醋	齰	
醇	錞	
醉	酔	
磕	溘	
磊	藞	
磅	嫎	
霉	苺	黴
瞒	慲	瞞
题	趧	題
暴	懪	
瞎	磍	
嘶	凘	
嘲	謿	
踏	沓	
踩	棌	
踪	琮	蹤
蝶	渫	
蝴	箶	
蝎		蠍
嘿	潶	
嘱	瞩	囑
墨	嚜	
镇	鎮	
镐	鎬	
镑		鎊
稻	稲	
稿	鎬	
稼	糘	
箱	葙	
篓	溇	簍
篇	萹	
僵	壃	
德	徳	
鲤		鯉
鲫	鯽	
熟	孰	
摩	嚤	
瘪	癟	
瘤	媹	
瘫		癱
凛		凜
颜	顔	顏
毅	藙	
糊	煳	
遵	噂	
潜	濳	潛
潮	謿	
潭	憛	
鲨	鯊	
澳	奧	
潘	瀋	
澈	瞮	
澜	瀾	
澄	僜	
懂	慬	
懊	襖	
憎	璔	
额		額
谴		譴
鹤		鶴
慰	墛	
劈	噼	
缭	繚	
擂	檑	
操	懆	
燕	嬿	
蕾	檑	
薪	蕲	
颠		顛
橱	廚	櫥
融	瀜	
醒	瑆	
霍	靃	
辙		轍
餐	爘	
嘴	觜	
蹄	渧	
器	噐	
噪	璪	
鹦	鸚	
赠	熷	贈
镜	傹	鏡
赞	瓒	贊
篮	藍	籃
篱		籬
儒	濡	
邀	撽	
衡	蘅	
雕	鵰	
鲸	鯨	
磨	嚤	
瘾	癮	
辨	辧	
辩	辮	辯
糙	鐰	
糖	溏	
糕	溔	
燃	嘫	
濒		瀕
澡	璪	
激	噭	
懒	攋	懶
懈	澥	
避	鐴	
缰	韁	
缴	儌	繳
戴	瀻	
擦	攃	
藏	蔵	
藐	邈	
檐		簷
磷	潾	
霜	灀	
霞	葭	
瞧	趭	
瞬	橓	
瞩		矚
瞪	簦	
蹈	稲	
赡		贍
魏	蘶	
繁	瀿	
徽	幑	
爵	嚼	
鳄	鱷	
辫	辮	
赢		贏
糟	蹧	
糠	嵻	
燥	璪	
懦	穤	
骤		驟
藕	耦	
藤	駦	
蹦	嘣	
嚣		囂
镰		鐮
翻	飜	
鳍	鰭	
鹰		鷹
瀑	鑤	
襟	噤	
戳	戥	
孽	糵	
警	檠	
蘑	嚤	
攀	襻	
蹲	壿	
蹭	竲	
蹬	簦	
巅	巔	
颤	顫	
癣		癬
鳖		鱉
爆	嚗	
疆	彊	
鬓	鬢	
躁	璪	
嚷	孃	
巍	蘶	
鳞	潾	鱗
魔	嚤	
糯	穤	
灌	潅	
霸	覇	
露	蕗	
霹	噼	
躏	躪	
赣		贛
囊	灢	
镶		鑲
罐	潅	
