# 中日韩共用常见八百汉字表（2014年公布）
# 汉字共808个
#
# 补充参考：https://dict.variants.moe.edu.tw/appendix.jsp?ID=8
#
#简化字	繁體字	日本語	韓國語

一	一	一	一
人	人	人	人
十	十	十	十
二	二	二	二
又	又	又	又
力	力	力	力
九	九	九	九
八	八	八	八
七	七	七	七
入	入	入	入
刀	刀	刀	刀
上	上	上	上
大	大	大	大
子	子	子	子
小	小	小	小
下	下	下	下
工	工	工	工
三	三	三	三
口	口	口	口
己	己	己	己
女	女	女	女
山	山	山	山
已	已	已	已
及	及	及	及
才	才	才	才
千	千	千	千
土	土	土	土
士	士	士	士
久	久	久	久
亡	亡	亡	亡
寸	寸	寸	寸
川	川	川	川
弓	弓	弓	弓
夕	夕	夕	夕
不	不	不	不
中	中	中	中
天	天	天	天
太	太	太	太
日	日	日	日
方	方	方	方
分	分	分	分
五	五	五	五
心	心	心	心
水	水	水	水
月	月	月	月
化	化	化	化
比	比	比	比
公	公	公	公
内	內	内	內
今	今	今	今
手	手	手	手
六	六	六	六
反	反	反	反
少	少	少	少
文	文	文	文
夫	夫	夫	夫
火	火	火	火
元	元	元	元
毛	毛	毛	毛
王	王	王	王
友	友	友	友
支	支	支	支
片	片	片	片
木	木	木	木
引	引	引	引
止	止	止	止
父	父	父	父
尺	尺	尺	尺
午	午	午	午
牛	牛	牛	牛
户	戶	戸	戶
氏	氏	氏	氏
井	井	井	井
仁	仁	仁	仁
犬	犬	犬	犬
他	他	他	他
以	以	以	以
可	可	可	可
生	生	生	生
出	出	出	出
主	主	主	主
用	用	用	用
去	去	去	去
民	民	民	民
本	本	本	本
外	外	外	外
加	加	加	加
四	四	四	四
正	正	正	正
由	由	由	由
平	平	平	平
代	代	代	代
白	白	白	白
立	立	立	立
打	打	打	打
北	北	北	北
世	世	世	世
必	必	必	必
目	目	目	目
市	市	市	市
布	布	布	布
石	石	石	石
母	母	母	母
未	未	未	未
半	半	半	半
示	示	示	示
古	古	古	古
史	史	史	史
失	失	失	失
功	功	功	功
田	田	田	田
皮	皮	皮	皮
令	令	令	令
左	左	左	左
句	句	句	句
右	右	右	右
玉	玉	玉	玉
冬	冬	冬	冬
兄	兄	兄	兄
永	永	永	永
末	末	末	末
巨	巨	巨	巨
幼	幼	幼	幼
甘	甘	甘	甘
仙	仙	仙	仙
申	申	申	申
册	冊	冊	冊
在	在	在	在
有	有	有	有
地	地	地	地
全	全	全	全
年	年	年	年
多	多	多	多
自	自	自	自
好	好	好	好
行	行	行	行
同	同	同	同
成	成	成	成
如	如	如	如
老	老	老	老
因	因	因	因
向	向	向	向
合	合	合	合
各	各	各	各
百	百	百	百
西	西	西	西
回	回	回	回
次	次	次	次
先	先	先	先
名	名	名	名
再	再	再	再
安	安	安	安
共	共	共	共
光	光	光	光
至	至	至	至
收	收	収	收
交	交	交	交
字	字	字	字
米	米	米	米
色	色	色	色
式	式	式	式
死	死	死	死
早	早	早	早
列	列	列	列
江	江	江	江
衣	衣	衣	衣
存	存	存	存
忙	忙	忙	忙
守	守	守	守
充	充	充	充
考	考	考	考
血	血	血	血
印	印	印	印
肉	肉	肉	肉
危	危	危	危
曲	曲	曲	曲
耳	耳	耳	耳
羊	羊	羊	羊
休	休	休	休
伐	伐	伐	伐
竹	竹	竹	竹
吉	吉	吉	吉
伏	伏	伏	伏
刑	刑	刑	刑
朱	朱	朱	朱
仰	仰	仰	仰
舌	舌	舌	舌
宅	宅	宅	宅
宇	宇	宇	宇
寺	寺	寺	寺
兆	兆	兆	兆
我	我	我	我
作	作	作	作
见	見	見	見
利	利	利	利
位	位	位	位
走	走	走	走
完	完	完	完
别	別	別	別
形	形	形	形
决	決	決	決
身	身	身	身
改	改	改	改
车	車	車	車
快	快	快	快
花	花	花	花
住	住	住	住
志	志	志	志
每	每	毎	每
更	更	更	更
究	究	究	究
近	近	近	近
何	何	何	何
步	步	歩	步
技	技	技	技
告	告	告	告
兵	兵	兵	兵
言	言	言	言
低	低	低	低
足	足	足	足
角	角	角	角
助	助	助	助
防	防	防	防
希	希	希	希
村	村	村	村
投	投	投	投
弟	弟	弟	弟
良	良	良	良
初	初	初	初
均	均	均	均
男	男	男	男
判	判	判	判
冷	冷	冷	冷
材	材	材	材
君	君	君	君
困	困	困	困
否	否	否	否
迎	迎	迎	迎
吹	吹	吹	吹
私	私	私	私
忘	忘	忘	忘
序	序	序	序
佛	佛	仏	佛
辛	辛	辛	辛
尾	尾	尾	尾
妙	妙	妙	妙
壮	壯	壮	壯
贝	貝	貝	貝
忍	忍	忍	忍
豆	豆	豆	豆
秀	秀	秀	秀
臣	臣	臣	臣
赤	赤	赤	赤
扶	扶	扶	扶
孝	孝	孝	孝
姊	姊	姉	姊
的	的	的	的
来	來	来	來
和	和	和	和
到	到	到	到
事	事	事	事
所	所	所	所
长	長	長	長
法	法	法	法
定	定	定	定
两	兩	両	兩
明	明	明	明
使	使	使	使
物	物	物	物
知	知	知	知
表	表	表	表
者	者	者	者
儿	兒	児	兒
命	命	命	命
性	性	性	性
果	果	果	果
门	門	門	門
东	東	東	東
放	放	放	放
官	官	官	官
争	爭	争	爭
取	取	取	取
育	育	育	育
直	直	直	直
治	治	治	治
金	金	金	金
受	受	受	受
非	非	非	非
油	油	油	油
林	林	林	林
空	空	空	空
往	往	往	往
易	易	易	易
京	京	京	京
服	服	服	服
河	河	河	河
若	若	若	若
注	注	注	注
英	英	英	英
苦	苦	苦	苦
始	始	始	始
念	念	念	念
武	武	武	武
例	例	例	例
雨	雨	雨	雨
固	固	固	固
夜	夜	夜	夜
协	協	協	協
免	免	免	免
承	承	承	承
依	依	依	依
波	波	波	波
居	居	居	居
呼	呼	呼	呼
妹	妹	妹	妹
味	味	味	味
松	松	松	松
季	季	季	季
枝	枝	枝	枝
宗	宗	宗	宗
招	招	招	招
店	店	店	店
幸	幸	幸	幸
妻	妻	妻	妻
抱	抱	抱	抱
虎	虎	虎	虎
卷	卷	巻	卷
姓	姓	姓	姓
典	典	典	典
彼	彼	彼	彼
奉	奉	奉	奉
舍	舍	舎	舍
忠	忠	忠	忠
宙	宙	宙	宙
泣	泣	泣	泣
昔	昔	昔	昔
卒	卒	卒	卒
是	是	是	是
要	要	要	要
活	活	活	活
面	面	面	面
后	後	後	後
看	看	看	看
前	前	前	前
政	政	政	政
度	度	度	度
重	重	重	重
相	相	相	相
便	便	便	便
军	軍	軍	軍
建	建	建	建
革	革	革	革
美	美	美	美
南	南	南	南
计	計	計	計
界	界	界	界
海	海	海	海
思	思	思	思
品	品	品	品
指	指	指	指
科	科	科	科
保	保	保	保
则	則	則	則
信	信	信	信
省	省	省	省
风	風	風	風
持	持	持	持
约	約	約	約
神	神	神	神
飞	飛	飛	飛
食	食	食	食
首	首	首	首
故	故	故	故
草	草	草	草
送	送	送	送
音	音	音	音
洋	洋	洋	洋
红	紅	紅	紅
城	城	城	城
客	客	客	客
屋	屋	屋	屋
律	律	律	律
施	施	施	施
急	急	急	急
星	星	星	星
待	待	待	待
春	春	春	春
限	限	限	限
室	室	室	室
香	香	香	香
退	退	退	退
祖	祖	祖	祖
威	威	威	威
洗	洗	洗	洗
昨	昨	昨	昨
拜	拜	拝	拜
秋	秋	秋	秋
厚	厚	厚	厚
追	追	追	追
皆	皆	皆	皆
勇	勇	勇	勇
恨	恨	恨	恨
皇	皇	皇	皇
怒	怒	怒	怒
俗	俗	俗	俗
祝	祝	祝	祝
拾	拾	拾	拾
泉	泉	泉	泉
柔	柔	柔	柔
哀	哀	哀	哀
怨	怨	怨	怨
逆	逆	逆	逆
个	個	個	個
时	時	時	時
能	能	能	能
家	家	家	家
起	起	起	起
高	高	高	高
气	氣	気	氣
原	原	原	原
展	展	展	展
通	通	通	通
华	華	華	華
特	特	特	特
书	書	書	書
马	馬	馬	馬
造	造	造	造
流	流	流	流
记	記	記	記
根	根	根	根
料	料	料	料
连	連	連	連
师	師	師	師
校	校	校	校
席	席	席	席
病	病	病	病
笑	笑	笑	笑
除	除	除	除
速	速	速	速
害	害	害	害
消	消	消	消
破	破	破	破
容	容	容	容
修	修	修	修
效	效	効	效
留	留	留	留
致	致	致	致
财	財	財	財
旅	旅	旅	旅
益	益	益	益
素	素	素	素
恩	恩	恩	恩
酒	酒	酒	酒
降	降	降	降
案	案	案	案
纸	紙	紙	紙
借	借	借	借
杀	殺	殺	殺
射	射	射	射
针	針	針	針
烈	烈	烈	烈
训	訓	訓	訓
夏	夏	夏	夏
骨	骨	骨	骨
孙	孫	孫	孫
庭	庭	庭	庭
岛	島	島	島
弱	弱	弱	弱
徒	徒	徒	徒
浪	浪	浪	浪
纯	純	純	純
乘	乘	乗	乘
耕	耕	耕	耕
悟	悟	悟	悟
泰	泰	泰	泰
浮	浮	浮	浮
胸	胸	胸	胸
栽	栽	栽	栽
勉	勉	勉	勉
眠	眠	眠	眠
浴	浴	浴	浴
国	國	国	國
得	得	得	得
动	動	動	動
都	都	都	都
进	進	進	進
着	着	着	着
部	部	部	部
问	問	問	問
从	從	従	從
现	現	現	現
著	著	著	著
理	理	理	理
第	第	第	第
将	將	将	將
情	情	情	情
常	常	常	常
接	接	接	接
设	設	設	設
许	許	許	許
务	務	務	務
基	基	基	基
深	深	深	深
处	處	処	處
眼	眼	眼	眼
望	望	望	望
商	商	商	商
习	習	習	習
参	參	参	參
婚	婚	婚	婚
球	球	球	球
细	細	細	細
推	推	推	推
族	族	族	族
船	船	船	船
鱼	魚	魚	魚
妇	婦	婦	婦
黄	黃	黄	黃
视	視	視	視
责	責	責	責
密	密	密	密
货	貨	貨	貨
救	救	救	救
终	終	終	終
停	停	停	停
章	章	章	章
顶	頂	頂	頂
假	假	仮	假
访	訪	訪	訪
野	野	野	野
麦	麥	麦	麥
唱	唱	唱	唱
菜	菜	菜	菜
堂	堂	堂	堂
移	移	移	移
异	異	異	異
脱	脫	脱	脫
执	執	執	執
贫	貧	貧	貧
败	敗	敗	敗
混	混	混	混
探	探	探	探
盛	盛	盛	盛
鸟	鳥	鳥	鳥
陆	陸	陸	陸
阴	陰	陰	陰
欲	欲	欲	欲
闭	閉	閉	閉
雪	雪	雪	雪
净	淨	浄	淨
浅	淺	浅	淺
虚	虛	虚	虛
惜	惜	惜	惜
授	授	授	授
患	患	患	患
宿	宿	宿	宿
凉	涼	涼	涼
昼	晝	昼	晝
崇	崇	崇	崇
祭	祭	祭	祭
就	就	就	就
道	道	道	道
发	發	発	發
过	過	過	過
等	等	等	等
无	無	無	無
然	然	然	然
间	間	間	間
量	量	量	量
最	最	最	最
结	結	結	結
给	給	給	給
期	期	期	期
万	萬	万	萬
报	報	報	報
运	運	運	運
极	極	極	極
统	統	統	統
劳	勞	労	勞
场	場	場	場
达	達	達	達
单	單	単	單
须	須	須	須
备	備	備	備
集	集	集	集
胜	勝	勝	勝
游	遊	遊	遊
喜	喜	喜	喜
落	落	落	落
黑	黑	黒	黑
买	買	買	買
坚	堅	堅	堅
阳	陽	陽	陽
富	富	富	富
答	答	答	答
扬	揚	揚	揚
叶	葉	葉	葉
朝	朝	朝	朝
云	雲	雲	雲
敢	敢	敢	敢
圆	圓	円	圓
画	畫	画	畫
减	減	減	減
短	短	短	短
饭	飯	飯	飯
善	善	善	善
童	童	童	童
散	散	散	散
恶	惡	悪	惡
贵	貴	貴	貴
植	植	植	植
登	登	登	登
敬	敬	敬	敬
景	景	景	景
伟	偉	偉	偉
遇	遇	遇	遇
顺	順	順	順
笔	筆	筆	筆
街	街	街	街
湖	湖	湖	湖
雄	雄	雄	雄
税	稅	税	稅
寒	寒	寒	寒
尊	尊	尊	尊
番	番	番	番
勤	勤	勤	勤
贺	賀	賀	賀
悲	悲	悲	悲
丧	喪	喪	喪
闲	閑	閑	閑
惠	惠	恵	惠
晴	晴	晴	晴
暑	暑	暑	暑
贮	貯	貯	貯
会	會	会	會
经	經	経	經
新	新	新	新
电	電	電	電
业	業	業	業
当	當	当	當
义	義	義	義
意	意	意	意
想	想	想	想
话	話	話	話
与	與	与	與
路	路	路	路
农	農	農	農
解	解	解	解
爱	愛	愛	愛
号	號	号	號
节	節	節	節
传	傳	伝	傳
势	勢	勢	勢
远	遠	遠	遠
感	感	感	感
温	溫	温	溫
试	試	試	試
满	滿	満	滿
岁	歲	歳	歲
烟	煙	煙	煙
伤	傷	傷	傷
福	福	福	福
汉	漢	漢	漢
罪	罪	罪	罪
暗	暗	暗	暗
园	園	園	園
诗	詩	詩	詩
禁	禁	禁	禁
圣	聖	聖	聖
暖	暖	暖	暖
诚	誠	誠	誠
愁	愁	愁	愁
慈	慈	慈	慈
说	說	説	說
对	對	対	對
种	種	種	種
实	實	実	實
领	領	領	領
认	認	認	認
图	圖	図	圖
算	算	算	算
广	廣	広	廣
精	精	精	精
银	銀	銀	銀
尽	盡	尽	盡
轻	輕	軽	輕
适	適	適	適
端	端	端	端
闻	聞	聞	聞
语	語	語	語
察	察	察	察
练	練	練	練
误	誤	誤	誤
歌	歌	歌	歌
绿	綠	緑	綠
荣	榮	栄	榮
谷	穀	穀	穀
鸣	鳴	鳴	鳴
鼻	鼻	鼻	鼻
渔	漁	漁	漁
寿	壽	寿	壽
暮	暮	暮	暮
论	論	論	論
数	數	数	數
线	線	線	線
质	質	質	質
热	熱	熱	熱
增	增	増	增
调	調	調	調
请	請	請	請
德	德	徳	德
谈	談	談	談
选	選	選	選
价	價	価	價
养	養	養	養
乐	樂	楽	樂
敌	敵	敵	敵
谁	誰	誰	誰
卖	賣	売	賣
诸	諸	諸	諸
课	課	課	課
亿	億	億	億
舞	舞	舞	舞
齿	齒	歯	齒
庆	慶	慶	慶
暴	暴	暴	暴
洁	潔	潔	潔
遗	遺	遺	遺
赏	賞	賞	賞
忧	憂	憂	憂
学	學	学	學
头	頭	頭	頭
战	戰	戦	戰
亲	親	親	親
树	樹	樹	樹
钱	錢	銭	錢
兴	興	興	興
余	餘	余	餘
独	獨	独	獨
桥	橋	橋	橋
灯	燈	灯	燈
静	靜	静	靜
忆	憶	憶	憶
应	應	応	應
声	聲	声	聲
讲	講	講	講
旧	舊	旧	舊
鲜	鮮	鮮	鮮
谢	謝	謝	謝
关	關	関	關
题	題	題	題
难	難	難	難
医	醫	医	醫
艺	藝	芸	藝
归	歸	帰	歸
虫	蟲	虫	蟲
药	藥	薬	藥
礼	禮	礼	禮
丰	豐	豊	豐
识	識	識	識
证	證	証	證
愿	願	願	願
劝	勸	勧	勸
议	議	議	議
严	嚴	厳	嚴
钟	鐘	鐘	鐘
竞	競	競	競
权	權	権	權
铁	鐵	鉄	鐵
续	續	続	續
欢	歡	歓	歡
露	露	露	露
听	聽	聴	聽
读	讀	読	讀
惊	驚	驚	驚
体	體	体	體
变	變	変	變
观	觀	観	觀
让	讓	譲	讓
强	強	強	强
开	開	開	開
举	舉	挙	擧
教	教	教	敎
历	歷	歴	歷
里	里	里	里
晚	晚	晩	晚
冰	冰	氷	氷
产	産	産	産
研	硏	研	硏
饮	飲	飲	飮
绝	絕	絶	絶
制	製	製	製
众	衆	衆	衆
真	真	真	眞
窗	窗	窓	窓
采	採	採	採
清	清	清	淸
青	青	青	靑
韩	韓	韓	韓
乡	鄉	郷	鄕
贤	賢	賢	賢
央	央	央	央
区	區	区	區
团	團	団	團
局	局	局	局
写	寫	写	寫
茶	茶	茶	茶
点	點	点	點
